1st floor (floor of doom)
22
8
###################
# H   #  K F#   GH#
#-#    #   #    H #
#H#HG   #-#G   H  #
# # H     #   HG  #
#H#  #####HHHH    #
# # H#      #  F G#
#H#H #    ###     #
# #G # H  #B B B B#
# # G#  # # B B B #
#H#  #    #B B B B#
# #H #G#  ##B B BW#
#H# H# G  #K B B B#
# #H #  G ##B B B #
#H#  #  H #B B B B#
#F#  #    # B B B #
# #B# #   #B B B  #
#H# HBFB  # B B   #
#K## PK|H #B B   X#
###################