2nd floor (the rooms)
22
8
###################
#G   B B  G #  H P#
#   B B B   #  HHH#
#    B B    #G    #
#   B BKB        F#
###-###############
#  B   HKH      G #
# F     H         #
#   G   B      G  #
#      B B     HH #
# G  G  B     H H #
#      B B     HH #
####-##########-###
#B B B B #WH    G #
# B BFB B#HH F    #
#K B B B #KH  G   #
#################B#
#    GH   H  G  # #
#X    H K H     | #
###################