attic (unstable grounds)
22
8
###################
#KB   #HP WH#  G K#
#  G  #GH HG#    H#
#     #H H H#  B  #
#  F  #FH HK###-###
#G    ###-### GB  #
#     #     B     #
# G   |    BFB    #
#    B#     B   K #
#####-#############
# G  BH H  H     F#
#      H G  H    H#
#   G  H   H   BHB#
#     H     H  H K#
#######HHHHH#######
# G  F# H H # G  K#
#HH  H|     |   F #
#KH G #  X  #  G  #
###################