basement (tutorial)
22
8
###################
#              G  #
#   G            K#
#                 #
#         G     F #
###-###############
#  B     G # G   W#
#     HH   #      #
#     H        F  #
#  G       #      #
#        K #      #
###-###########-###
#G B #         B  #
#    #           G#
#    #   ##########
#   F#   #     G  #
#    #        H   #
#HH  #   #        #
#P  K# X #G     K #
###################